
NO          ./textures/txt_stone/pared_piedra_2.png

SO      ./textures/txt_stone/pared_piedra.png

WE               textures/txt_stone/Paredbloquespiedra.png

EA  ./textures/txt_stone/paredbloquespiedra2.png

DOOR        ./textures/txt_stone/WoodDoor.png
SPRITE      ./textures/txt_stone/dhalsim.png

F          79,88,76
 
C 0,216,255


111111111111111111111111
111111111111111111111111
110000000000000000000001
100000000000000000000001
100000000000000000000001
1000000000000000U0000001
100000000000000000000001
111111000000000000000001
111111000000000000000001
1  111000011D1100000001
1111U0000100001000000001
100000001000000100000001
10000011000000001110001
111D11100000000000D00001
100000111100001111100001
10000000001001000000111
100000000010010000001
10000000001111100000111
100U00000001100000000001
100000000000000000000001
100000000000000000000001
100001111110000000000001
100001    10000000U00011
100001111111111111111111
11000D000000E00000000001
 1111111111111111111111









                    1111111
                    1100001
                    1100001
                    1000001
                    1111111