NO ./textures/Gold_wall.png
SO ./textures/wall_rock.png
WE textures/ladrillo_wall.png
EA ./textures/Wood_wall.png
F 222,200,54
DOOR ./textures/txt_stone/Puerta1.png
SPRITE ./textures/txt_stone/dhalsim.png
C 0,216,255

111111111111111111111111
110000000000000000000001
100000000000000000000001
100000000000000000000001
1000000000000000U00000011
10000000000000000000000D1
1111110000000010000000011
111111000000010000000001
1  1110000100D100000001
1111U0000100011000000001
100000001000000100000001
10000011000000001100001
100000100000000000100001
100000111100001111000001
10000000001001000000111
100000000010010000001
10000000001111100000111
100U00000001100000000001
100000000000000000000001
1000000000000000N0000001
100001111110000000000001
100001    10000000U00011
100001111111111111111111
110000000000000000000001
 1111111111111111111111









                    1111111
                    1100001
                    1100001
                    1000001
                    1111111