NO ./textures/wall_N.png
SO ./textures/wall_S.png
WE ./textures/wall_L.png
EA ./textures/wall_R.png
DOOR        ./textures/txt_stone/Puerta1.png
SPRITE      ./textures/txt_stone/dhalsim.png
F 0,255,0
C 0,216,255

                  111
                  101
        11111111111D111111111111
        1100000000000000000000011
        1000000000000000000000011
        1100000000000000000000001
        100000000000S000000000011
        100000000000000000000001
        10000000000000000000000111111
        11111100000000000000000D00001
        100000000011D100000000111111
        100000000100001000000001
        100000001000000100000001
        100000110000000011000001
        1000001000000000D0100001
        100000111100001111000001
        100000000010010000001111
        100000000010010000001
        100000000010010000001111
  111111100000000001100000000001
  100000000000000000000001111111
  100000000000000000000001
  100000000000000000000001111111111111
  111111111111100000000000000000000001
        100000D00000000000000011111111
        111111111111111111111111