NO          ./textures/Gold_wall.png
SO          ./textures/wall_rock.png
WE          textures/ladrillo_wall.png
EA          ./textures/Wood_wall.png
DOOR        ./textures/txt_stone/Puerta1.png
SPRITE      ./textures/txt_stone/dhalsim.png
F           222,200,54
C           0,216,255
111111111111111111111111
110000000000000000000001
100000000000000000000001
100000000000000000000001
1000000000000000U0000001
100000000000000000000001
111111000000000000000001
111111000000000000000001
1  11100001000100000001
1111U0000100001000000001
100000001000000100000001       1111111111
10000011000000001100001        1000000001
100000100000000000100001       1000000001
100000111100001111000001       1000000001
10000000001001000000111111111111000000001
10000000001001000000D00000000000000000001
10000000001111100000111111111111000000001
100U00000001100000000001       1000000001
100000000000000000000001       100U000001
1000000000000000N0000001       1111111111
100001111110000000000001
100001    10000000U00011
100001111111111111111111
110000000000000000000001
 1111111111111111111111